0 12 11 12 11 13 0 0 14 13 3 11 3 0 3
0 1 14 1 14 4 14 0 0 4 11 12 0 0 0
0 0 12 11 12 13 0 14 14 13 3 14 3 14 3
14 1 14 1 14 13 14 0 0 4 12 11 12 11 12
11 12 11 12 11 12 0 0 0 13 3 14 3 14 3
12 1 12 1 12 0 0 0 0 0 11 12 11 12 11
4 13 4 13 0 0 0 5 0 0 0 13 4 13 4
11 12 11 12 11 0 0 0 0 0 11 1 11 1 11
2 14 2 14 2 13 0 14 14 13 12 11 12 11 12
12 11 12 11 12 4 14 0 0 13 14 1 14 1 0
2 0 2 14 2 13 0 0 14 13 11 12 11 0 0
0 0 11 12 11 4 14 14 0 4 14 1 14 1 0

